source,cluster,n_pleio_pos,n_pleio_neg,n_pleio_none,n_pleio_any,n_pleio_net,n_bfa_envs,wmu_x_home,wse_home,wmu_x_away,wse_away,n_bcs,wsd_away
02M_NaCl,1,5,0,5,5,5,10,0.031405863915697725,0.006985253010347345,0.007765819072415802,0.003086275976248366,55,0.009759661572804564
02M_NaCl,2,3,0,7,3,3,10,0.04077906436712196,0.010149938415126646,5.957890844570602e-4,0.004077272934352903,4,0.012893469114713361
02M_NaCl,3,8,0,2,8,8,10,0.029451177468048376,0.004080237353744275,0.02760163978632431,0.005019508669605174,3,0.015873080130913944
02M_NaCl,5,4,1,5,5,3,10,0.022049805300424875,0.0014869555347466867,0.018724063200493697,0.01757026071154861,3,0.05556204293146434
02M_NaCl,6,5,0,5,5,5,10,0.0194161562554645,0.0059239423195886,0.014938756285187085,0.004432389599070835,1,0.014016446610304382
02M_NaCl,7,6,1,3,7,5,10,0.01677736428273,0.005433780098667162,0.012854085032265915,0.005144479485241547,1,0.01626827254937387
21C,1,5,0,5,5,5,10,0.024665500658825973,0.003938598363209403,0.010366490600437515,0.003794268783104132,122,0.011998531409484458
21C,10,9,0,1,9,9,10,0.037116376068075,0.0029052201415102875,0.033399196204584786,0.011133132415456258,1,0.03520605592509376
21C,2,6,0,4,6,6,10,0.011031756308362959,0.0021422034961570617,0.010191255876248095,0.0020440531287357483,4,0.006463863545198337
21C,4,7,2,1,9,5,10,0.03413310206159973,0.003914523997457129,0.003376998734211143,0.007318458434110882,3,0.023142997613059702
21C,5,8,0,2,8,8,10,0.0287173989028675,0.004475867810736525,0.026269772421599027,0.005456456506995395,1,0.017254830515751926
21C,6,5,4,1,9,1,10,0.007128735228648566,0.002628917000077718,0.001277857436287005,0.005017870702696323,2,0.01586790042474999
21C,7,6,0,4,6,6,10,0.0410144439343196,0.006591438896414273,0.01603357950278618,0.006385013832226648,3,0.020191186601516423
21C,8,6,2,2,8,4,10,0.03180804431061861,0.0033099221639324833,0.0041789919783039265,0.00893252519712481,2,0.028247124879758934
21C,9,4,1,5,5,3,10,0.00731736851782195,0.004705724517463737,0.015043474125197315,0.005268508223650072,1,0.016660485858062016
37C,1,3,2,5,5,1,10,0.017107947104922274,0.00611127889361909,-0.005723200295929381,0.004916957574407679,7,0.015548785093545106
37C,10,9,0,1,9,9,10,0.060526967771165625,0.004589635442638025,0.031050749947115396,0.01127227110641987,1,0.035646051099193055
37C,2,1,2,7,3,-1,10,0.017871741989112958,0.010389990710193989,-0.01084370028559581,0.003823157689777936,3,0.012089886153685718
37C,3,2,2,6,4,0,10,0.011766377704475726,0.005644986163128113,-0.004452440286081744,0.007180454942576945,1,0.022706592254756696
37C,4,6,0,4,6,6,10,0.024879423483084532,0.010351317160092735,0.005998685258848564,0.003557343361489103,2,0.011249307441585279
37C,5,8,0,2,8,8,10,0.015667390493516408,0.004990319735524808,0.013201363649109937,0.003217566004550701,11,0.010174837096307912
37C,7,2,1,7,3,1,10,0.010100533485136625,0.0054010077521343,-0.006198540278610634,0.0056524535034656095,1,0.017874627439149787
37C,9,1,1,8,2,0,10,0.0057818281650306,0.0054146014281419375,0.0021095014741141197,0.00649288995688006,1,0.02053232086057345
CLM,1,2,4,4,6,-2,10,0.7308111624161391,0.059151869330088314,-0.002429160847593089,0.033551222732909856,81,0.10609828211961433
CLM,2,2,8,0,10,-6,10,0.7121612337007175,0.02548362208692425,-0.01821361577088312,0.04415659030767412,1,0.13963539907916545
FLC4,1,2,7,1,9,-5,10,0.5158660370430022,0.052390469496101155,-0.047112996003107775,0.009424725440467645,496,0.029803598713611424
FLC4,2,3,7,0,10,-4,10,0.220694380074517,0.05825952948464813,-0.02033933332974873,0.008707054354314774,33,0.027534123470521425
FLC4,3,2,6,2,8,-4,10,0.40003320071627657,0.002168447819392867,NaN,NaN,2,NaN
FLC4,4,2,8,0,10,-6,10,0.359984417963762,0.11537861523853771,-0.03307510363703422,0.0070367796291815506,8,0.02225225102088875
FLC4,5,2,2,6,4,0,10,0.6167657886473648,0.23783792829454534,-0.019836888525002767,0.004387626056124074,4,0.01387489185845385
FLC4,6,4,2,4,6,2,10,0.6673182954092911,0.017664482502947186,-0.009008347558993868,0.007251981563948195,7,0.022932779291626324
FLC4,7,2,7,1,9,-5,10,0.11383177387738544,0.06502790796181109,-0.042372585095926694,0.01216826942697052,2,0.038479446571818766
GlyEtOH,1,3,0,7,3,3,10,0.06172911585392329,0.012504062442617174,0.003922052599322458,0.0041430004736950935,48,0.01310131784403301
GlyEtOH,10,2,4,4,6,-2,10,0.04953495438259172,0.01472609836455558,NaN,NaN,4,NaN
GlyEtOH,12,4,3,3,7,1,10,0.056548669765665624,0.005300324598922925,-0.00925352503510095,0.006143463012913261,1,0.01942733584180633
GlyEtOH,13,3,1,6,4,2,10,0.043903406700679624,0.006160455988841663,0.005590211083660228,0.005922538344046345,1,0.018728710696868385
GlyEtOH,14,3,7,0,10,-4,10,0.07418354515573088,0.004568309669219388,-0.027447791057765066,0.005282023159010636,1,0.016703223836231344
GlyEtOH,15,3,7,0,10,-4,10,0.07717921456196625,0.004645647038841688,-0.03540411886988723,0.009436112345509907,1,0.02983960726904503
GlyEtOH,2,3,6,1,9,-3,10,0.034118419250405534,0.013480838149828544,-0.0321585744712313,0.009767401462125914,19,0.030887235441576743
GlyEtOH,3,2,5,3,7,-3,10,0.06082938742007464,0.015040828559497118,-0.03677914858153136,0.0062116463955050535,4,0.01964295062937107
GlyEtOH,4,2,2,6,4,0,10,0.03257913149969375,0.01179829832586508,-0.016856689552890016,0.003480169665201104,19,0.01100526278586112
GlyEtOH,5,6,1,3,7,5,10,0.065987988052249,0.004633797149877825,0.00707763211906526,0.007471756854507355,1,0.02362776978321857
GlyEtOH,6,2,4,4,6,-2,10,0.06397564218709012,0.00545717703827995,-0.01537336854393048,0.007712900537654772,1,0.02439033306532637
GlyEtOH,7,8,0,2,8,8,10,0.04398311131256872,0.010524561229529628,0.013118232173125518,0.00490810580979392,5,0.015520793356053945
GlyEtOH,9,7,2,1,9,5,10,0.030801177169090272,0.004795634284604347,0.005670686851874531,0.004515600884056662,5,0.014279583797888967
pH3_8,1,7,0,3,7,7,10,0.010093048884442513,0.0023826487314831425,0.00826776417583259,0.005282307637810929,21,0.016704123437186306
pH3_8,3,6,0,4,6,6,10,0.03905193678243875,0.005457521857418587,0.021820889125167834,0.004100523327974279,1,0.01296699331505236
pH3_8,6,6,0,4,6,6,10,0.023123772848412,0.0059795505891772375,0.015446252882964874,0.005163216283689245,1,0.0163275235085281
pH3_8,7,7,0,3,7,7,10,0.02116847694778375,0.005689688429939913,0.021741680603299018,0.005731901189975223,1,0.0181258630833512
pH3_8,8,4,3,3,7,1,10,0.04474106829255075,0.00563603101107555,0.013579082084554729,0.008349966799213087,1,0.026404913472299216
pH7_3,3,2,3,5,5,-1,10,0.01339771305387335,0.011330696137521279,-0.009740105371825809,0.004560217250462537,17,0.014420673136652153
pH7_3,4,2,5,3,7,-3,10,0.058515189873064206,0.00886850514501669,-0.018295595749098167,0.007914712189255652,6,0.025028517542745515
pH7_3,5,4,0,6,4,4,10,0.0440027534646385,0.005025295145031562,0.006072621837926471,0.0058622553845594895,1,0.018538079240794265
SC,1,6,0,4,6,6,10,0.013027192726479874,0.004464908675598738,0.014032672882002353,0.005058689637843022,1,0.01599698123147626
YPD,1,3,3,4,6,0,10,0.004227026595276205,0.0022519703984920443,-0.003947623326472906,0.005300745394316714,13,0.01676242874268817
YPD,2,8,0,2,8,8,10,0.0092359320898719,0.006357067325729425,0.017386785729252754,0.005557715632006405,1,0.017575039984662442
YPD,3,7,1,2,8,6,10,0.005022221728310825,0.004785168609100675,0.01433386866567139,0.006703180338007908,1,0.021197317434962334
