source,cluster,n_pleio_pos,n_pleio_neg,n_pleio_none,n_pleio_any,n_pleio_net,n_bfa_envs,wmu_x_home,wse_home,wmu_x_away,wse_away,n_bcs,wsd_away
21C,1,4,0,4,4,4,8,0.0031561789429594626,0.0037240197325632374,0.017785760904656115,0.008618677866762502,1,0.024377302257800694
21C,2,8,0,0,8,8,8,0.04781744157487275,0.0029692459140247375,0.06430876983110355,0.004339252040798526,1,0.012273258173304814
CLM,1,1,3,4,4,-2,8,NA,NA,-9.300871616187576e-4,0.007992854939139057,13,0.02260720771402247
CLM,2,1,3,4,4,-2,8,NA,NA,0.0019695625472273717,0.01154970925794813,43,0.03266751094811268
CLM,3,1,5,2,6,-4,8,NA,NA,-0.12487443490279235,0.027637083428285452,2,0.078169476417436
CLM,4,1,5,2,6,-4,8,NA,NA,-0.008870629097246601,0.013732699400170504,3,0.03884193947942799
CLM,5,2,2,4,4,0,8,NA,NA,0.002949476106654188,0.012772858929963455,1,0.036127100658065237
CLM,6,1,4,3,5,-3,8,NA,NA,-2.7152175814449927e-4,0.010060710098625478,1,0.02845598533716022
FLC4,1,5,2,1,7,3,8,0.07588926573133184,0.003746426441177645,0.013451573287923823,0.01192957305595903,11,0.03374192801811582
FLC4,10,2,4,2,6,-2,8,0.068627121532395,0.001320707051549443,-0.0428797295425782,0.01693902449727543,2,0.04791079635483403
FLC4,11,2,1,5,3,1,8,0.07504373048750661,0.008748620512734414,-0.0046038630810318355,0.004201444637765124,6,0.011883479976574308
FLC4,12,3,3,2,6,0,8,0.07100048285125238,0.004897275788725688,-0.010935609957727237,0.007525311341988861,1,0.021284794721841447
FLC4,13,1,4,3,5,-3,8,0.05915839530191875,0.005461856205199975,-0.021669721364859555,0.005831742709458361,1,0.01649465926397287
FLC4,14,2,3,3,5,-1,8,0.07364904094222963,0.005671350185928887,-0.01848204209198956,0.008246905942152489,1,0.023325772462014636
FLC4,2,3,5,0,8,-2,8,0.06541588237781203,0.006300145000276006,-2.705554101020157e-4,0.01260582786007092,2,0.03565466544930582
FLC4,3,7,1,0,8,6,8,0.056850098616901254,0.004296946023910409,-0.0171419860507607,0.024519505860207007,2,0.06935163546038267
FLC4,4,1,3,4,4,-2,8,0.07417297202024187,0.007100539377649798,-0.010789767619633156,0.0018044054711528763,3,0.005103629378649225
FLC4,5,2,2,4,4,0,8,0.0811215011168972,0.00949564170528123,-4.937671383596459e-4,0.004691687062068691,14,0.01327009494717585
FLC4,6,1,2,5,3,-1,8,0.08233161363678354,0.006702237726842991,-0.005057651851658014,0.00327476925504831,5,0.009262446188263515
FLC4,7,2,1,5,3,1,8,0.07043565854267773,0.030495821127743836,0.005139449183851206,0.0031410519700307794,10,0.008884236592272514
FLC4,8,2,3,3,5,-1,8,0.07979933562764902,0.005350732899809667,0.012234746259757743,0.004889771841934752,2,0.013830363311548395
FLC4,9,7,1,0,8,6,8,0.1209420248356766,0.0017970028825746562,0.057896609755982875,0.010077723125227894,2,0.02850410544307652
GlyEtOH,1,2,4,2,6,-2,8,0.0807236737590503,0.02651715743169899,-0.01855028285561759,0.010224429669165713,7,0.028919054211328017
GlyEtOH,10,4,2,2,6,2,8,0.12639543594467656,0.002468953321266686,4.877247773603016e-5,0.012448174110801506,4,0.03520875330855427
GlyEtOH,11,2,4,2,6,-2,8,0.10663597963490801,0.0017565276584547145,NaN,NaN,3,NaN
GlyEtOH,12,4,3,1,7,1,8,0.11655470071992624,0.008629754925094211,-0.006591742920560731,0.014626269656332238,2,0.04136933782982224
GlyEtOH,13,2,3,3,5,-1,8,0.06931152537958363,0.011467237609291513,-1.959487146550932e-4,0.00768798299154576,1,0.02174489962787539
GlyEtOH,14,3,2,3,5,1,8,0.13280376861361376,0.009952434247993138,-0.007551824909344265,0.013661097859520922,1,0.038639419739681095
GlyEtOH,2,4,3,1,7,1,8,0.12564524003757768,0.007466061841735598,0.023741649118327688,0.00800265664244336,29,0.02263493111751707
GlyEtOH,3,1,1,6,2,0,8,0.08394289288094332,0.012922159788300814,0.0031810914607547725,0.0038924553874492593,17,0.011009526399725926
GlyEtOH,4,3,2,3,5,1,8,0.0672189694672421,0.0031436131805042166,0.0037158568342803345,0.007816221216393422,2,0.022107612101463815
GlyEtOH,5,1,3,4,4,-2,8,0.11804117286621825,0.010162653729909337,-0.011136265146129143,0.007866622353955126,1,0.022250168046061405
GlyEtOH,6,2,2,4,4,0,8,0.11936762301127139,0.027825473679465203,0.007543504640705195,0.012592675754528406,3,0.03561746567724184
GlyEtOH,7,1,3,4,4,-2,8,0.13828417183950376,0.01033254811877195,-0.021095611836075986,0.006381931018829582,1,0.01805082680191668
GlyEtOH,8,2,4,2,6,-2,8,0.11768065519919346,0.0101076593314984,-0.04583201570915068,0.01145361235663757,3,0.03239570786584184
GlyEtOH,9,3,1,4,4,2,8,0.11673954648589813,0.010647249535796788,0.004614622909743955,0.006458621084149164,1,0.018267739062865142
pH7_3,1,2,3,3,5,-1,8,0.008204734171629513,0.0028251912443641018,-0.004258285582465331,0.004528388688919693,62,0.012808217399134299
SC,1,2,0,6,2,2,8,0.00918839229020285,0.004140584889826412,0.006321452877432458,0.004149077602204224,1,0.01173536363275131
SC,2,3,0,5,3,3,8,0.016402599233184875,0.00376324603642085,0.0044033150596076605,0.0032064991846378066,1,0.009069349269306115
SC,3,3,0,5,3,3,8,0.010028208921293675,0.004350728396916375,0.015123957724370243,0.005350761638603053,1,0.015134239356676247
SC,4,1,0,7,1,1,8,0.0042231754542201875,0.0047458485376840375,0.0065103617560826966,0.004605255718598973,1,0.013025630190877843
SC,5,1,1,6,2,0,8,0.006763460156005784,0.003138465611630633,-0.015096788556255075,0.0032959540164553573,2,0.009322365742058483
YPD,1,8,0,0,8,8,8,0.09229795489638724,0.0019474740049982126,0.07505935283935196,0.006783378212736449,1,0.019186290934316105
YPD,2,0,0,8,0,0,8,0.014893697830430238,0.00943925414853685,NaN,NaN,4,NaN
